21111111111111000000
00000000000001000000
00000000000001000000
00000000000001000000
00000111111111110000
01000100000000010000
01000100000000010000
00000111111111100000
00000000001000000010
00000000001000011110
01111111111000000000
01000001000000000000
01000001000001111110
01000001000001000010
01000001111111000010
01111100000001000010
00000100000001000000
00000111111001000000
00000000001111111110
00000000000000000013
