21000000000000000000
01111100011111111110
00000100010000000010
00000100010001110010
00011111111111010010
01000100000000010010
01000100000000010010
01111100001111110010
00000000001000000010
00000000001000011110
01111111111000111110
01000001000000000010
01000001000001110010
01000001000001000010
01000001111111000010
01111100000000000010
00000100000000000000
00000111111000000000
00000000001111111110
00000000000000000013
