21000000000000000000
01111100011111111110
00000100010000000010
11000100010000110010
11000111110000010010
11000100000000010010
11110100000000010010
10010001101111110010
10010000001000000010
10010000001000011110
01111111111111111110
01000001000000000010
01000001000001110010
01111001000001000010
01001001111111000010
01111100000000100010
00000100000000111110
00001111111000000000
00001000000111111000
00001111111111111113
