21101110111010111110
01010101010101010000
01110101010101010000
01010111010101010000
01011101010101010000
01010101010101110000
01110101010101010000
01010101010101010000
01010101110101010000
01010111010101010000
01010101010101010000
01010101010101010000
01110101010111010000
01010101010101010000
01010111010101010000
01011101010101010000
01010101110101010000
01010111010101010000
01011101010101011100
01010101011101010113
